NO textures/north.png
SO textures/south.png
WE textures/east.png
EA textures/west.png

C 35,19,73
F 15,6,40

111111111111111
110000000000001
110000000000001
1000000N0000001
110000000000001
100000000000001
100000000000001
100000000000001
100000000000001
111111111111111