NO textures/north.png
SO textures/south.png
WE textures/east.png
EA textures/west.png

C 35,19,73
F 15,6,40

111111111111111
110000000000111
111000000000111
1111000N0001111
110000000000001
110000000000011
100000000000001
100000000000011
110000000000111
111100000001111
111000000000111
111111000111111
111111111111111